  R   800 800
       NO       ./images/10.xpm
        SO     ./images/camen.xpm
WE                ./images/green.xpm
          S  ./images/barrel.xpm
           EA  ./images/greenstone.xpm
         C           0,0,0
  F    255,0,255
1111111111111111111111           111
1000000000111111           111
100002000111
1000111000111
12001 10120011
1000111000111
11111111011111111111111111111111111111111111111111111111111111111111111111
100000S00001
111111111111