R   1920 1080
NO  ./images/10.xpm
SO  ./images/camen.xpm
WE  ./images/green.xpm
S   ./images/barrel.xpm
EA  ./images/greenstone.xpm
C 255,255,255
F 255,255,255

111111111111111111111111111
100000000000000000000000001
100000000000000000000000001
100000000000000000000000001
100000000000000S00000000001
100000000000000000000000001
100000000000000000000000001
100000000200000000000000001
100000000000000000002000001
100000000000000000000000001
100000000000000000000000001
111111111111111111111111111